XXXXXXXXXXXXXXXXXXXXXXXXXXXXXXXXXX
XXXXXX-----XXXXXXXXXXXXXXXXXXXXXXX
XXXX---------XXXXXXXXXXXXXXXXXXXXX
XXX-----------XXXXXXXXX---XXXXXXXX
XX----XXXX-----XXXXXXX--------XXXX
X----XXXXX-----XXXXX------------XX
X----XXXXXX-----XXXX-----XXX----XX
X----XXXXXX-----XXXX------XX-----X
X-----XXXXX------XXXX------XX----X
XX----XXXXX------XXXXX-----XX----X
XX-----XXXX------XXXX------XX----X
XXX-----XXXX------XXX------XX----X
XXXX----XXXXX------------XXX-----X
XXXXX-P-XXXXXX---------XXXXXFFFFFX
XXXXXXXXXXXXXXXXX---XXXXXXXXXXXXXX
XXXXXXXXXXXXXXXXXXXXXXXXXXXXXXXXXX
