XXXXXXXXXXXXXXXXXXXX
XXXXXXF-------XXXXXX
XXXXXXF---------XXXX
XP--XXXXXXXXX----XXX
X----XXXX---------XX
XX----XX---------XXX
XXX-------XXXXXXXXXX
XXXXXXXXXXXXXXXXXXXX