XXXXXXXXXXXXXXXXXXXX
XXXX-------XXXXXXXXX
XX-----------XXXXXXX
X----XXXX-----XXXXXX
X---XXX------XXXXXXX
X---X------XXXXXXXXX
X---X----XXXXXXXXXXX
X---X---XXXXXXXXXXXX
X-P-X---XXXXXXXXXXXX
XXXXX---XXXXXX--XXXX
XFFFX---XXXX------XX
X---X---XX---------X
X---X---------X----X
X---XX------XXXX---X
X---XXXXXXXXXXXX---X
X---XXXXXXXXXXX----X
X----XXX-----------X
XX----------------XX
XXX----------XXXXXXX
XXXXXXXXXXXXXXXXXXXX